48,48,48,48,48,48,48,48,48,48
41,46,46,46,46,46,46,46,46,41
47,22,22,22,22,22,22,22,22,47
47,22,22,22,22,22,22,22,22,47
47,22,22,22,22,22,22,22,22,47
40,41,22,22,22,22,22,22,22,47
-1,40,41,22,22,22,22,22,22,47
-1,-1,47,22,22,22,22,22,22,47
-1,41,40,22,22,22,22,22,22,47
41,40,22,22,22,22,22,22,22,47
47,22,22,22,22,22,22,22,22,47
47,22,22,22,22,22,22,22,22,47
47,22,22,22,22,22,22,22,22,47
40,22,22,22,22,22,22,22,22,40